2 2
7 7
#########
# #######
#  ######
##  #####
###  ####
####  ###
#####  ##
######  #
#########