1 1
21 5
#########################
#                       #
####################### #
#                       #
# #######################
#                       #
#########################