1 1
12 1
#########################
#                       #
####################### #
#                       #
#########################